11111111111111111111111
1E0000000000000C00000C1
1010010100100X001010011
10X010010101010001P0101
100000000X0000000X00011
11111111111111111111111